21,21,,,,,,,,,,,,,,,,,,,

*,*,*,*,*,*,*,*,*,*,*,*,*,*,*,*,*,*,*,*,*
*,s,c,c,*,c,c,c,c,c,c,c,c,c,c,c,*,c,c,s,*
*,c,*,c,*,c,*,*,c,*,*,*,c,*,*,c,*,c,*,c,*
*,c,*,c,*,c,*,c,c,c,*,c,c,c,*,c,*,c,*,c,*
*,c,c,c,c,c,c,c,*,c,c,c,*,c,c,c,c,c,c,c,*
*,*,*,*,c,*,*,c,*,*,*,*,*,c,*,*,c,*,*,*,*
*,c,c,c,c,c,c,c,*,c,c,c,*,c,c,c,c,c,c,c,*
*,c,*,*,*,*,c,*,*,c,*,c,*,*,c,*,*,*,*,c,*
*,c,c,c,c,*,c,c,c,c,c,c,c,c,c,*,c,*,*,c,*
*,c,*,*,c,*,c,*,*,*,c,*,*,*,c,*,c,*,*,c,*
*,c,*,*,c,*,c,c,c,c,p,c,c,c,c,*,c,*,*,c,*
*,c,*,*,c,*,c,*,*,*,*,*,*,*,c,*,c,c,c,c,*
*,*,*,*,c,*,c,c,c,c,c,c,c,c,c,*,c,*,*,*,*
*,c,c,c,c,*,c,*,*,*,*,*,*,*,c,*,c,c,c,c,*
*,c,*,*,c,c,c,c,c,c,t,c,c,c,c,c,c,*,*,c,*
*,c,c,c,c,*,c,*,*,*,c,*,*,*,c,*,c,c,c,c,*
*,s,*,*,c,*,c,c,c,*,*,*,c,c,c,*,c,*,*,s,*
*,c,*,*,c,*,c,*,c,c,c,c,c,*,c,*,c,c,c,c,*
*,c,*,*,*,*,c,*,c,*,*,*,c,*,c,*,*,*,*,c,*
*,c,1,c,c,c,2,*,c,c,c,c,c,*,3,c,c,c,c,4,*
*,*,*,*,*,*,*,*,*,*,*,*,*,*,*,*,*,*,*,*,*
